..................................
..................................
..................................
..................................
..................................
...#...#####...#####.......#####..
...#...........#.........#........
...#.....#......#.........#.......
...#.....#......#.........#.......
...#.....#....#.........#.........
...###..###......#.........#......
...#.....#......#.........#.......
...#.....#......#.........#.......
...#.....#......#.........#.......
...#######......#.......##########
..................................
..................................
..................................
..................................
..................................
..................................
..................................
..................................
..................................
..................................
..................................
..................................
..................................
..................................
..................................
..................................
..................................
..................................
..................................
..................................